165,190,370,20,1,
90,155,60,10,1,
130,10,320,10,1,
15,125,70,10,1,
160,75,20,10,1,
110,75,20,10,1,
45,65,130,10,1,
235,65,150,10,1,
225,125,150,10,1,
